111111111111111
100000000010001
100P00000010001
100000001110001
100CCC010000001
111111100000001
100000000000E01
111111111111111