1111111111
100CCE0001
10C00P0001
100CCCC001
100000C001
1111111111