1111111111
10000E0001
100P000001
1000000001
100000C001
1111111111