111111111111111
100000010000P01
100000010000001
10C000010C00001
1000C0010C00001
1000000E0000001
111111111111111